AR - ARGENTINA
AT - AUSTRIA
AU - AUSTRALIA
BE - BELGIUM
BR - BRAZIL
CA - CANADA
CN - CHINA
CZ - CZECH REPUBLIC
DK - DENMARK
EC - ECUADOR
FI - FINLAND
FR - FRANCE
DE - GERMANY
HU - HUNGARY
IE - IRELAND
IN - INDIA
IT - ITALY
JP - JAPAN
KR - KOREA
LU - LUXEMBOURG
MX - MEXICO
NL - NETHERLANDS
NO - NORWAY
PL - POLAND
PT - PORTUGAL
RU - RUSSIA
ZA - SOUTH AFRICA
ES - SPAIN
SE - SWEDEN
CH - SWITZERLAND
US - UNITED STATES
UK - UNITED KINGDOM